####################
#  @   # \   @    #
#  ###  #  !   @  #
#      @#  ###    #
#  @  @ #  !   D  #
#   !   #   @     #
#  ####### @  @   #
#                  #
####################
140
