####  ###########
# @           @ #
     /      @   #
#  @     @      #
#           #   #
#        @      #
#     @  ! D    #
#     @      #  #
#!            @ #
#################
180              