#################
# @           @ #
#    /      @   #
#  @    @       #
#           #   #
#        @      #
#     @  !      #
#     @      #  #
#  !!!!         #
#################