####################
# \  @  # !   @   #
#  @### #  @      #
#    @  #  ###  ! #
#  @    #     @   #
#  ###  #  !  @ D #
#  @    ########  #
#                  #
####################
120
